3,1,2,5,1,28,28,2,16,1,34,1,112,1,1,1,3,1,34,1,26,3,3
1,1,34,26,3,28,28,1,16,3,21,15,15,34,15,15,19,1,3,35,28,28,1
2,3,28,28,34,32,31,1,34,1,1,1,3,1,1,3,34,1,2,1,2,26,87
36,1,28,28,1,32,31,3,1,1,2,2,1,1,28,28,4,29,29,29,4,9,1
1,18,15,26,1,28,28,27,3,1,1,1,1,112,28,28,3,3,34,1,1,34,1
3,16,28,28,87,28,28,27,28,28,34,1,2,1,5,1,3,1,1,1,3,16,3
1,16,28,30,1,30,28,1,28,28,1,29,4,30,30,34,1,2,3,1,1,16,2
34,16,3,1,2,3,1,1,90,28,4,30,34,3,1,1,1,1,1,1,34,20,1
1,34,1,2,2,1,34,1,7,9,34,1,1,1,1,3,18,34,3,2,1,1,3
3,1,1,1,1,2,16,1,2,15,20,3,18,15,2,1,16,2,1,1,1,1,3
3,1,1,2,3,34,20,3,1,1,1,1,34,7,9,1,34,1,2,2,1,34,1
1,18,34,1,1,1,1,1,1,3,34,29,4,28,160,1,1,3,2,1,3,16,34
2,16,1,1,3,2,1,34,29,29,4,30,1,28,28,1,28,29,1,29,28,16,1
3,16,3,1,1,1,3,1,5,1,2,1,34,28,28,27,28,28,157,28,28,16,3
1,34,1,1,34,3,3,28,28,112,1,1,1,1,3,27,28,28,1,26,15,20,1
1,7,4,29,29,29,4,28,28,1,1,2,2,1,1,3,32,31,1,28,28,1,36
157,26,2,1,2,1,34,3,1,1,3,1,1,1,34,1,32,31,34,28,28,3,2
1,28,28,35,3,1,21,15,15,34,15,15,19,3,16,1,28,28,3,26,34,1,1
3,3,26,1,34,1,3,1,1,1,112,1,34,1,16,2,28,28,1,5,2,1,3
